TW NO NO DL NO NO NO TW NO NO NO DL NO NO TW
NO DW NO NO NO TL NO NO NO TL NO NO NO DW NO
NO NO DW NO NO NO DL NO DL NO NO NO DW NO NO
DL NO NO DW NO NO NO DL NO NO NO DW NO NO DL
NO NO NO NO DW NO NO NO NO NO DW NO NO NO NO
NO TL NO NO NO TL NO NO NO TL NO NO NO TL NO
NO NO DL NO NO NO DL NO DL NO NO NO DL NO NO
TW NO NO DL NO NO NO NO NO NO NO DL NO NO TW
NO NO DL NO NO NO DL NO DL NO NO NO DL NO NO
NO TL NO NO NO TL NO NO NO TL NO NO NO TL NO
NO NO NO NO DW NO NO NO NO NO DW NO NO NO NO
DL NO NO DW NO NO NO DL NO NO NO DW NO NO DL
NO NO DW NO NO NO DL NO DL NO NO NO DW NO NO
NO DW NO NO NO TL NO NO NO TL NO NO NO DW NO
TW NO NO DL NO NO NO TW NO NO NO DL NO NO TW