NO NO NO NO NO NO NO NO NO NO NO NO NO NO NO
NO NO NO NO NO NO NO NO NO NO NO NO NO NO NO
NO DL DL DL NO NO NO NO NO NO NO DL DL DL NO
NO DL NO DL NO NO NO NO NO NO NO DL NO DL NO
NO DL DL DL NO NO NO NO NO NO NO DL DL DL NO
NO NO NO NO NO NO NO NO NO NO NO NO NO NO NO
NO NO NO NO NO NO NO NO NO NO NO NO NO NO NO
NO NO NO NO NO NO NO DW NO NO NO NO NO NO NO
NO NO NO DL NO NO NO NO NO NO NO DL NO NO NO
NO NO NO DL NO NO NO NO NO NO NO DL NO NO NO
NO NO NO NO DL NO NO NO NO NO DL NO NO NO NO
NO NO NO NO NO DL DL DL DL DL NO NO NO NO NO
NO NO NO NO NO NO NO NO NO NO NO NO NO NO NO
NO NO NO NO NO NO NO NO NO NO NO NO NO NO NO
NO NO NO NO NO NO NO NO NO NO NO NO NO NO NO